FE7 - Fields - 1c1d1e1f
25 20
131 131 131 131 131 131 21 245 245 245 245 245 276 276 245 245 22 652 463 491
131 131 131 131 131 131 55 245 245 245 245 245 276 245 245 24 684 652 559 524
131 131 131 817 131 131 125 245 245 245 245 245 244 245 20 131 684 652 652 495
131 131 784 785 131 131 21 88 245 245 245 245 244 124 131 99 99 684 685 684
131 131 131 816 131 131 131 131 21 245 245 245 213 22 131 99 99 131 684 684
131 131 131 131 131 131 131 131 131 25 88 212 24 131 131 976 942 977 131 131
131 131 131 131 131 131 131 131 131 131 131 600 35 131 131 973 974 975 131 131
131 131 131 131 131 131 900 131 131 131 131 632 131 131 131 1005 1006 1007 131 131
131 131 131 131 131 836 330 131 131 131 782 600 131 131 131 868 396 868 131 131
131 131 131 131 804 391 299 131 131 804 782 632 131 131 131 131 396 131 131 131
131 131 131 131 131 396 131 131 131 684 685 599 570 630 131 131 396 131 131 131
645 131 131 131 131 396 131 131 131 131 652 685 685 599 597 131 396 131 131 131
131 645 131 131 131 396 131 131 783 131 131 652 685 685 599 539 34 571 570 570
868 131 641 131 131 396 131 784 785 131 131 131 131 131 131 131 396 720 131 131
131 131 641 131 131 396 131 131 131 131 131 131 131 131 131 131 396 131 131 131
784 785 641 131 131 869 337 337 337 337 337 337 337 337 337 337 869 131 131 131
131 131 131 643 131 131 131 131 131 131 131 131 131 131 131 131 131 131 131 131
131 131 131 801 131 131 131 131 131 131 131 131 131 131 131 131 131 131 131 131
131 165 801 131 131 131 131 131 131 721 723 723 131 131 131 131 131 131 131 131
131 131 131 131 131 131 131 131 721 754 754 723 723 131 131 131 131 131 131 131
131 131 131 131 131 131 131 721 755 807 808 809 754 723 131 131 131 131 131 131
131 131 131 131 131 131 131 721 755 839 840 841 754 723 131 131 131 131 131 131
131 131 131 131 131 131 131 131 721 871 872 873 721 131 131 131 131 131 131 131
131 131 131 131 131 131 131 131 131 782 396 782 131 131 131 131 131 131 131 131
131 131 131 131 131 131 131 131 131 131 396 131 131 131 131 131 131 131 131 131
